4444444444444444444444444444444444444444
4000000000000000000000000000000000000004
4000001111111111111111000000000000000004
4000001111111111111111000444400000000004
4000001111111111111111000444000000000004
4001111110000000000000000044002220000004
4001111110000004444440000000222220000004
4001111110000000044444440000222222220004
4001111110000000000000000000002222220004
4000000000000000000000000000000002220004
4000000000000111111111100000000000000004
4000000000000111111111100000000000000004
4000444000000111144441111000000000000004
4000444000000111144444111000004440000004
4000444000000111111441111110000444000004
4000000000000111111441100000000004440004
4000000000000111114441100000000000000004
4444444444444444444444444444444444444444